// التوكن هنا
token = Njg3NzIwNTkxNDE5MjQ0NTQ0.Xmp31A.U7pEFOc668sxrNavzM-i16FJjjU
// ايدي اونر البوت
owner = 673293597419896832
// البرفكس حق البوت
prefix = M
// البلينق الثابت حق البوت
game = M Play
// حالة البوت
status = DND
// امر الهيلب لو تريد تعدله
help = help
// يبقى بلروم بعد م تخلص الاغنية
stayinchannel = true
// تحذير التحديثات
updatealerts=false
// مايحتاج اشرحه
lyrics.default = "A-Z Lyrics"
// اختصارات
aliases {
  // General commands
  settings = [ status ]

  // Music commands
  lyrics = []
  nowplaying = [ np, current ]
  play = [ p ]
  playlists = [ pls ]
  queue = [ list ]
  remove = [ delete ]
  scsearch = []
  search = [ ytsearch ]
  shuffle = []
  skip = [ voteskip ]

  // Admin commands
  prefix = [ setprefix ]
  setdj = [ dj ]
  settc = [ tc ]
  setvc = [ vc ]

  // DJ Commands
  forceremove = [ forcedelete, modremove, moddelete ]
  forceskip = [ fs ]
  movetrack = [ mt ]
  pause = []
  playnext = [ pn]
  repeat = [ rep ]
  skipto = [ jumpto ]
  stop = []
  volume = [ vol ]
}
